1111111111111
11P000C000111
111111110C111
1E000C01C0001
1111111111111
