1111111111111
11P000C000111
111111110C111
1E000C00C01C1
1111111111111
